|,-,-,-,-,-,-,-,-,-,-,-,|
|, , , ,|, , , ,|, , , ,|
|, ,|, ,|, ,|, ,|, ,|, ,|
|, ,|, , , ,|, , , ,|, ,|
|, , , ,|,-,-,-,|, , , ,|
-,-, ,|,-,-,-,-,-,|, ,-,-
|,|, , , , ,0, , , , ,|,|
|,|, ,|, ,-,-,-, ,|, ,|,|
-,-, ,|, ,|,|,|, ,|, ,-,-
|, , , , ,-,-,-, , , , ,|
|, ,-,-, , , , , ,-,-, ,|
|, ,|,|, ,-,-,-, ,|,|, ,|
|, ,|,|, , , , , ,|,|, ,|
|, ,-,-, ,-,-,-, ,-,-, ,|
|, , , , ,|,|,|, , , , ,|
|,-,-,-,-,|,|,|,-,-,-,-,|